1111111111111111111111111111111
10000000000000000000000000000E1
1000000C01000000000010000001001
1000110C01110001100011100001111
1000000C01110000000011100001111
1000000C00000000000000000000001
1000000C01000000000010000001001
1000110C00000001100000000000001
1111100P00111111100001111100111
1000000001000000000010000001001
1111111111111111111111111111111