111111
10E111
1CP111
111111
111111