11111111111111111111111111111111111
1P000000000C0000000000C0000000000C1
10000000010000000000100000000001001
10001100011100011000111000110001111
10000000011100000000111000000001111
10000000000C0000000000C0000000000C1
10000000010000000000100000000001001
10001100000000011000000000110000001
11111000001111111000011111110000111
10000000010000000000100000000001001
10000110000000001100000000011000E01
11111111111111111111111111111111111