111111111111111111111111111
10E100000000000001100100001
1C00P00001C01000000C0000001
111100001111100001111100001
111111111111111111111111111